107
14
22 0 0 0 0 0 0 0 0 0 0 0 0 0 0 0 0 0 0 0 0 0 0 0 0 0 0 0 0 0 0 0 0 0 0 0 0 0 0 0 0 0 3 22 22 22 22 22 22 22 22 22 22 22 22 22 22 22 22 22 22 22 22 22 22 22 22 22 22 22 22 22 22 22 22 4 0 0 0 0 0 0 0 0 0 0 0 0 0 0 3 22 22 22 22 22 22 22 22 22 22 22 22 22 22 22 22 
22 0 0 0 0 0 0 0 0 0 0 0 0 0 9 10 0 11 0 9 0 10 11 10 0 0 0 11 0 10 0 0 0 0 0 0 0 0 0 0 0 0 0 17 18 22 22 22 22 22 22 22 22 22 22 22 22 22 22 22 19 17 17 17 17 17 17 17 17 17 18 22 22 22 22 4 0 0 0 0 0 0 0 0 0 0 0 0 0 0 0 18 22 22 22 22 22 19 17 17 17 17 17 17 17 18 22 
22 4 0 0 0 0 0 0 0 0 11 0 1 21 21 21 21 21 21 21 21 21 21 21 21 21 21 21 21 21 21 2 0 0 0 0 0 0 0 0 10 0 0 0 0 17 17 17 18 22 22 22 22 22 22 22 22 22 22 22 4 0 0 0 0 0 0 0 0 0 0 17 18 22 22 4 0 0 0 0 0 0 0 0 0 0 0 0 0 0 0 0 18 22 22 22 22 4 0 0 0 0 0 0 0 3 22 
22 4 0 0 0 0 0 0 0 23 25 0 3 22 22 22 22 22 22 22 22 22 22 22 22 22 22 22 22 22 22 4 0 0 11 0 0 0 0 23 24 25 0 0 0 0 0 0 0 17 17 18 22 22 22 22 22 22 22 19 0 0 10 0 11 0 0 0 0 0 0 0 0 17 17 0 0 0 0 0 0 0 0 0 0 0 0 0 0 0 0 0 0 18 22 22 22 4 0 0 0 0 0 0 0 3 22 
22 4 0 0 0 0 9 0 0 0 0 0 3 22 22 22 22 22 19 17 17 17 17 17 17 18 22 22 22 19 17 0 0 23 25 0 0 0 0 0 0 0 0 0 0 9 11 0 0 0 0 0 17 17 17 17 17 17 17 0 0 1 21 21 21 21 2 0 0 0 0 0 0 0 0 0 0 0 0 0 9 11 0 1 21 21 21 2 0 0 0 0 0 0 18 22 22 4 0 0 0 0 0 0 0 3 22 
22 4 0 0 0 0 23 25 0 0 0 0 0 17 17 17 17 17 0 0 0 0 10 9 0 0 18 22 19 0 10 0 0 0 0 0 0 11 0 0 0 0 0 1 21 21 21 21 2 0 0 0 9 0 0 0 0 9 0 0 0 3 22 22 22 22 21 2 0 0 0 0 0 0 0 0 0 0 0 23 24 25 0 3 22 22 22 4 0 0 0 0 0 0 0 17 17 0 0 0 0 0 0 0 0 3 22 
22 4 0 10 9 0 0 0 0 0 0 0 0 0 11 0 10 0 0 0 1 21 21 21 21 2 0 17 9 1 21 21 2 0 9 1 21 21 2 0 0 0 0 3 22 22 22 22 4 10 0 1 21 2 0 0 1 21 2 11 1 21 6 22 22 22 22 21 2 0 0 0 0 9 0 0 10 9 0 0 11 0 0 3 22 22 22 4 0 0 11 0 0 10 0 0 9 0 0 10 11 0 0 9 0 3 22 
22 4 23 24 25 0 0 0 0 0 0 0 0 0 23 24 24 24 25 0 3 22 22 22 22 21 21 21 21 21 6 5 21 21 21 21 6 22 4 0 0 0 0 3 22 22 22 5 21 21 21 21 21 21 21 21 21 21 21 21 21 6 22 22 22 22 22 22 4 0 0 1 21 21 21 21 21 21 21 21 21 21 21 21 6 22 5 21 21 21 21 21 21 21 21 21 21 21 21 21 21 21 21 21 21 21 6 
22 4 0 0 0 0 9 10 11 0 0 11 0 0 0 0 0 0 0 0 3 22 22 22 22 22 22 22 22 22 22 22 22 22 22 22 22 22 4 0 0 0 0 3 22 22 22 19 17 17 17 17 17 17 17 17 17 17 17 17 17 17 17 17 17 17 17 17 0 11 11 3 22 22 22 22 22 22 22 22 22 22 22 22 22 22 22 22 22 22 22 22 22 22 22 22 22 22 22 22 22 22 22 22 22 22 22 
22 4 0 0 0 0 23 24 25 0 23 24 25 0 0 0 0 0 0 0 3 22 22 22 19 17 17 17 17 17 17 17 17 17 17 17 17 17 0 0 0 0 0 3 22 22 19 0 0 0 23 24 24 24 24 24 24 25 0 0 0 0 0 0 0 0 0 0 0 23 25 3 22 22 22 22 22 22 22 22 22 22 22 22 22 22 22 22 22 22 22 22 22 22 22 22 22 22 22 22 22 22 22 22 22 22 22 
22 4 11 0 9 0 0 0 0 0 0 0 0 0 0 0 0 0 0 0 3 22 22 19 0 0 0 0 0 0 0 0 0 0 0 0 0 10 0 9 0 0 0 3 22 19 0 0 11 0 0 0 0 0 0 0 0 0 0 0 0 0 0 0 0 0 10 9 0 0 0 3 22 22 22 22 22 22 22 22 22 22 22 22 22 22 22 22 22 22 22 22 22 22 22 22 22 22 22 22 22 22 22 22 22 22 22 
22 4 23 24 25 0 0 0 0 0 0 0 0 0 0 0 0 0 0 0 3 22 22 4 0 0 0 10 0 0 0 0 11 0 0 1 21 21 21 21 21 2 11 0 17 0 0 0 23 25 0 0 0 0 0 0 0 0 10 9 0 11 0 10 0 0 23 24 25 0 0 3 22 22 22 22 22 22 22 22 22 22 22 22 22 22 22 22 22 22 22 22 22 22 22 22 22 22 22 22 22 22 22 22 22 22 22 
22 4 0 0 0 0 10 0 0 0 0 0 10 0 11 0 0 11 0 10 0 17 17 11 0 1 21 21 21 2 1 21 21 2 0 3 22 22 22 22 5 21 21 21 21 21 2 0 0 0 0 0 0 0 0 0 0 0 23 24 24 24 24 24 25 0 0 0 0 0 0 3 22 22 22 22 22 22 22 22 22 22 22 22 22 22 22 22 22 22 22 22 22 22 22 22 22 22 22 22 22 22 22 22 22 22 22 
5 21 21 21 21 21 21 21 2 0 1 21 21 21 21 21 21 21 21 21 21 21 21 21 21 21 6 22 5 21 21 6 5 21 2 3 22 22 22 22 22 22 22 22 22 5 21 2 0 0 0 0 0 0 0 0 0 0 0 0 0 0 0 0 0 0 0 0 0 0 0 3 22 22 22 22 22 22 22 22 22 22 22 22 22 22 22 22 22 22 22 22 22 22 22 22 22 22 22 22 22 22 22 22 22 22 22 
